ability: [Die Fähigkeit, la capacidad]
absence: [Die Abwesenheit, la ausencia]
accent: [Der Akzent, el acento]
access: [Die Zugriffs, el acceso]
accident: [Der Unfall, el accidente]
account: [Das Konto, la cuenta]
act: [Der Akt, el acto]
action: [Die Aktion, la acción]
activity: [Die Aktivität, la actividad]
actor: [Der Schauspieler, el actor]
address: [Die Adresse, la dirección]
adult: [Die Erwachsene, el adulto]
advance: [Der Vormarsch, el avance]
advantage: [Der Vorteil, La ventaja]
adventure: [Das Abenteuer, la aventura]
advice: [Der Ratschlag, el consejo]
affair: [Die Affäre, el asunto]
afternoon: [Der Nachmittag, la tarde]
age: [Das Alter, la edad]
agency: [Die Agentur, la agencia]
agent: [Der Agent, el agente]
agreement: [Die Vereinbarung, el acuerdo]
air: [Die Luft, el aire]
airport: [Der Flughafen, el aeropuerto]
alarm: [Den Wecker, la alarma]
alcohol: [Der Alkohol, el alcohol]
ambulance: [Der Krankenwagen, la ambulancia]
american: [Die Amerikaner, la americana]
amount: [Die Summe, la cantidad]
angel: [Der Engel, el ángel]
anger: [Die Wut, la ira]
angle: [Der Winkel, el ángulo]
animal: [Das Tier, el animal]
answer: [Die Antwort, la respuesta]
anxiety: [Die Angst, la ansiedad]
apartment: [Die Wohnung, el apartamento]
appearance: [Die Erscheinung, la aparición]
apple: [Der Apfel, la manzana]
appointment: [Der Termin, el nombramiento]
approach: [Der Ansatz, el enfoque]
area: [Das Gebiet, la zona]
argument: [Das Argument, el argumento]
arm: [Der Arm, el brazo]
army: [Die Armee, el ejército]
arrangement: [Die Vereinbarung, la disposición]
arrival: [Die Ankunft, la llegada]
art: [Die Kunst, el arte]
article: [Den Artikel, el artículo]
artist: [Der Künstler, el artista]
aspect: [Das Aspekt, el aspecto]
assignment: [Die Zuordnung, la asignación]
assistant: [Der Assistent, el asistente]
atmosphere: [Atmosphäre, la atmósfera]
attack: [Der Angriff, el ataque]
attempt: [Der Versuch, el intento]
attention: [Die Aufmerksamkeit, la atención]
attitude: [Die Attitüde, la actitud]
audience: [Das Publikum, la audiencia]
aunt: [Die Tante, la tía]
author: [Der Autor, el autor]
authority: [Die Autorität, la autoridad]
autumn: [Der Herbst, el otoño]
avenue: [Die Straße, la avenida]
baby: [Das Baby, el bebé]
back: [Der Rücken, la parte de atrás]
background: [Der Hintergrund, el fondo]
bag: [Der Beutel, la bolsa]
balance: [Die Balance, el balance]
ball: [Der Ball, la pelota]
band: [Die Band, la banda]
bank: [Die Bank, el banco]
bar: [Die Bar, el bar]
basket: [Der Korb, la cesta]
bastard: [Der Bastard, el hijo de puta]
bath: [Das Bad, el baño]
bathroom: [Das Bad, el cuarto de baño]
battery: [Die Batterie, la batería]
battle: [Der Kampf, la batalla]
bay: [Die Bucht, la bahía]
beach: [Der Strand, la playa]
beam: [Der Strahl, el haz]
bean: [Die Bohne, el frijol]
bear: [Der Bär, el oso]
beauty: [Die Schönheit, la belleza]
bed: [Das Bett, la cama]
bedroom: [Das Schlafzimmer, el dormitorio]
beer: [Das Bier, La cerveza]
beginning: [Der Anfang, el principio]
being: [Das Sein, el ser]
belief: [Der Glaube, la creencia]
bell: [Die Glocke, la campana]
belt: [Der Gürtel, el cinturón]
bench: [Die Bank, la magistratura]
benefit: [Der Vorteil, el beneficio]
bible: [Die Bibel, la biblia]
bike: [Das Fahrrad, la moto]
bill: [Die Rechnung, el proyecto de ley]
bird: [Der Vogel, el pájaro]
birth: [Die Geburt, el nacimiento]
birthday: [Der Geburtstag, el cumpleaños]
bishop: [Der Bischof, el obispo]
black: [Die Schwarze, el negro]
blade: [Die Klinge, la cuchilla]
blanket: [Die Decke, la manta]
block: [Der Block, el bloque]
blood: [Das Blut, la sangre]
blow: [Der Schlag, el golpe]
blue: [Das Blaue, el azul]
board: [Die Tafel, el tablero]
boat: [Das Boot, el barco]
body: [Der Körper, el cuerpo]
bomb: [Die Bombe, la bomba]
bond: [Die Bindung, el vínculo]
bone: [Der Knochen, el hueso]
book: [Das Buch, el libro]
boom: [Der Boom, el boom]
boot: [Das Boot, la bota]
border: [Die Grenze, la frontera]
boss: [Der Chef, el jefe]
bottle: [Die Flasche, la botella]
bottom: [Der Boden, la parte inferior]
bowl: [Die Schale, el cuenco]
box: [Die Kiste, la caja]
boy: [Der Junge, el niño]
brain: [Das Gehirn, el cerebro]
branch: [Der Ast, la rama]
brand: [Die Marke, la marca]
bread: [Das Brot, el pan]
break: [Die Pause, la ruptura]
breakfast: [Das Frühstück, el desayuno]
breast: [Die Brust, la mama]
breath: [Der Atem, la respiración]
brick: [Die Ziegel, el ladrillo]
bridge: [Die Brücke, el puente]
brother: [Der Bruder, el hermano]
brush: [Der Pinsel, el cepillo]
building: [Das Gebäude, el edificio]
burden: [Die Last, la carga]
bureau: [Das Büro, la oficina]
bus: [Der Bus, el autobús]
bush: [Der Busch, la zarza]
business: [Das Geschäft, el negocio]
butter: [Die Butter, la mantequilla]
button: [Der Knopf, el botón]
cab: [Das Taxi, la cabina]
cabinet: [Das Kabinett, el armario]
cable: [Das Kabel, el cable]
cake: [Der Kuchen, la torta]
call: [Der Anruf, la llamada]
camera: [Die Kamera, la cámara]
camp: [Das Camp, el campamento]
campaign: [Die Kampagne, la campaña]
cancer: [Der Krebs, el cáncer]
cap: [Die Kappe, la tapa]
capital: [Das Kapital, la capital]
captain: [Der Kapitän, el capitán]
car: [Das Auto, el coche]
card: [Die Karte, la tarjeta]
care: [Die Pflege, el cuidado]
career: [Die Karriere, la carrera]
carpet: [Der Teppich, la alfombra]
carriage: [Der Wagen, el carro]
case: [Der Fall, el caso]
cash: [Das Geld, el dinero en efectivo]
castle: [Die Burg, el castillo]
cat: [Die Katze, el gato]
cause: [Der Grund, la causa]
ceiling: [Die Decke, el techo]
cell: [Die Zelle, la célula]
century: [Das Jahrhundert, el siglo]
ceremony: [Die Zeremonie, la ceremonia]
chain: [Die Kette, la cadena de]
chair: [Der Stuhl, la silla]
challenge: [Die Herausforderung, el desafío]
chamber: [Die Kammer, la cámara de]
champagne: [Der Champagner, el champagne]
chance: [Die Chance, la oportunidad]
change: [Der Wechsel, el cambio]
channel: [Der Kanal, el canal]
chapel: [Die Kapelle, la capilla]
chapter: [Das Kapitel, el capítulo]
character: [Der Charakter, el carácter]
charge: [Die Ladung, la carga]
chart: [Das Diagramm, el gráfico]
check: [Die Prüfung, el cheque]
cheek: [Die Wange, la mejilla]
cheese: [Der Käse, el queso]
chest: [Die Brust, el pecho]
chicken: [Das Huhn, el pollo]
chief: [Der Chef, el jefe]
child: [Das Kind, el niño]
childhood: [Die Kindheit, la infancia]
chip: [Der Chip, el chip]
chocolate: [Die Schokolade, el chocolate]
choice: [Die Wahl, la elección]
church: [Die Kirche, la iglesia]
cigarette: [Die Zigarette, el cigarrillo]
circle: [Der Kreis, el círculo]
circumstance: [Der Umstand, la circunstancia]
citizen: [Der Bürger, el ciudadano]
city: [Die Stadt, la ciudad]
claim: [Der Anspruch, la reclamación]
class: [Die Klasse, la clase]
classroom: [Das Klassenzimmer, el aula]
clay: [Der Ton, la arcilla]
clerk: [Der Angestellte, el secretario]
client: [Der Klient, el cliente]
cliff: [Die Klippe, el acantilado]
clinic: [Die Klinik, la clínica]
clock: [Die Uhr, el reloj]
cloth: [Die Kleidung, el paño]
clothing: [Die Bekleidung, la ropa]
cloud: [Die Wolke, la nube]
club: [Der Club, el club]
clue: [Der Schlüssel, la clave]
coach: [Der Trainer, el entrenador]
coal: [Die Kohlen, el carbón]
coast: [Die Küste, la costa]
coat: [Der Mantel, la capa]
code: [Der Code, el código]
coffee: [Der Kaffee, el café]
coin: [Die Münze, la moneda]
cold: [Die Kälte, el frío]
colleague: [Der Kollege, el colega]
collection: [Die Sammlung, la colección]
college: [Das College, la universidad]
colonel: [Der Oberst, el coronel]
colony: [Die Kolonie, la colonia]
column: [Die Kolumne, la columna]
combination: [Die Kombination, la combinación]
comfort: [Der Komfort, la comodidad]
command: [Der Befehl, el comando]
commander: [Der Kommandant, el comandante]
comment: [Der Kommentar, el comentario]
committee: [Das Komitee, el comité]
communication: [Die Kommunikation, la comunicación]
community: [Die Gemeinde, la comunidad]
companion: [Der Begleiter, el compañero]
company: [Das Unternehmen, la empresa]
complaint: [Die Beschwerde, la queja]
computer: [Der Computer, el ordenador]
concentration: [Die Konzentration, la concentración]
concept: [Das Konzept, el concepto]
concern: [Die Sorge, la preocupación]
concert: [Das Konzert, el concierto]
conclusion: [Das Fazit, la conclusión]
condition: [Die Bedingung, la condición]
conference: [Die Konferenz, la conferencia]
confidence: [Das Vertrauen, la confianza]
confusion: [Die Verwirrung, la confusión]
connection: [Die Verbindung, la conexión]
consciousness: [Das Bewusstsein, la conciencia]
consequence: [Die Konsequenz, la consecuencia]
construction: [Die Konstruktion, la construcción]
contact: [Der Kontakt, el contacto]
content: [Der Inhalt, el contenido]
contract: [Der Vertrag, el contrato]
control: [Die Kontrolle, el control]
conversation: [Die Unterhaltung, la conversación]
copper: [Das Kupfer, el cobre]
copy: [Die Kopie, la copia]
core: [Der Kern, el núcleo]
corner: [Die Ecke, la esquina]
corridor: [Der Korridor, el corredor]
cost: [Die Kosten, el costo]
cottage: [Die Hütte, la casa de campo]
cotton: [Die Baumwolle, el algodón]
council: [Der Rat, el ayuntamiento]
count: [Die Zählung, el recuento]
counter: [Der Zähler, el contador]
country: [Das Land, el país]
county: [Die Kreis, el condado]
couple: [Das Ehepaar, la pareja]
course: [Der Kurs, el curso]
court: [Das Gericht, la corte]
cousin: [Der Cousin, el primo]
cover: [Die Titelseite, la tapa]
cow: [Die Kuh, la vaca]
crack: [Der Riss, la grieta]
craft: [Das Handwerk, la nave]
crash: [Der Absturz, el accidente]
cream: [Die Creme, la crema]
creation: [Die Kreation, la creación]
creature: [Die Kreatur, la criatura]
credit: [Der Kredit, el crédito]
crew: [Die Besatzung, la tripulación]
crime: [Das Verbrechen, el crimen]
crisis: [Die Krise, la crisis]
cross: [Das Kreuz, la cruz]
crowd: [Die Menge, la multitud]
crown: [Die Krone, la corona]
cry: [Das Weinen, el grito]
crystal: [Der Kristall, el cristal]
culture: [Die Kultur, la cultura]
cup: [Die Tasse, la copa]
curtain: [Die Gardine, la cortina]
curve: [Die Kurve, la curva]
customer: [Dem Kunden, el cliente]
cut: [Der Schnitt, el corte]
dad: [Der Vater, el papá]
daddy: [Der Papa, el papá]
damage: [Der Schaden, el daño]
dance: [Der Tanz, la danza]
danger: [Die Gefahr, el peligro]
dark: [Die Dunkelheit, la oscuridad]
darkness: [Dunkelheit, la oscuridad]
darling: [Der Liebling, el niño mimado]
data: [Die Daten, los datos]
date: [Das Datum, la fecha]
daughter: [Die Tochter, la hija]
day: [Der Tag, el día]
deal: [Der Deal, el acuerdo]
dealer: [Der Händler, el distribuidor]
death: [Der Tod, la muerte]
decade: [Das Jahrzehnt, la década]
decision: [Die Entscheidung, la decisión]
deck: [Das Deck, la cubierta]
degree: [Der Grad, el grado]
delight: [Die Freude, el deleite]
delivery: [Die Lieferung, la entrega]
demand: [Die Nachfrage, la demanda]
department: [Die Abteilung, el departamento]
depression: [Die Depression, la depresión]
depth: [Die Tiefe, la profundidad]
deputy: [Der Stellvertretende, el diputado]
description: [Die Beschreibung, la descripción]
desert: [Die Wüste, el desierto]
design: [Das Design, el diseño]
desire: [Das Verlangen, el deseo]
desk: [Der Schreibtisch, el escritorio]
detail: [Das Detail, el detalle]
detective: [Der Detektiv, el detective]
development: [Die Entwicklung, el desarrollo]
device: [Das Gerät, el dispositivo]
devil: [Der Teufel, el diablo]
diamond: [Der Diamant, el diamante]
diary: [Das Tagebuch, el diario]
difference: [Der Unterschied, la diferencia]
difficulty: [Die Schwierigkeit, la dificultad]
dinner: [Das Abendessen, la cena]
direction: [Die Richtung, la dirección]
director: [Der Direktor, el director]
disappointment: [Die Enttäuschung, la decepción]
disaster: [Das Unglück, el desastre]
discovery: [Der Fund, el descubrimiento]
discussion: [Die Diskussion, la discusión]
disease: [Die Krankheit, la enfermedad]
dish: [Das Gericht, el plato]
display: [Der Bildschirm, la pantalla]
distance: [Die Distanz, la distancia]
district: [Das Viertel, el distrito]
divorce: [Die Scheidung, el divorcio]
dock: [Das Dock, el muelle]
doctor: [Der Doktor, el médico]
document: [Das Dokument, el documento]
dog: [Der Hund, el perro]
door: [Die Tür, la puerta]
doorway: [Die Türöffnung, la puerta]
doubt: [Der Zweifel, la duda]
draft: [Der Entwurf, el proyecto]
drama: [Das Drama, el drama]
drawing: [Die Zeichnung, el dibujo]
dream: [Der Traum, el sueño]
dress: [Das Kleid, el vestido]
drink: [Das Getränk, la bebida]
drive: [Die Fahrt, la unidad]
driver: [Der Fahrer, el controlador]
drop: [Der Fall, la caída de]
drug: [Das Medikament, la droga]
duck: [Die Ente, el pato]
duke: [Der Herzog, el duque]
dust: [Der Staub, el polvo]
duty: [Die Pflicht, el deber]
eagle: [Der Adler, el águila]
ear: [Das Ohr, el oído]
earl: [Der Graf, el conde]
earth: [Die Erde, la tierra]
edge: [Die Ecke, el borde]
education: [Die Bildung, la educación]
effect: [Der Effekt, el efecto]
effort: [Der Aufwand, el esfuerzo]
egg: [Das Ei, el huevo]
element: [Das Element, el elemento]
emergency: [Der Notfall, la emergencia]
emotion: [Die Emotion, la emoción]
emperor: [Der Kaiser, el emperador]
empire: [Das Reich, el imperio]
employee: [Der Arbeitnehmer, el empleado]
end: [Das Ende, el fin]
enemy: [Der Feind, el enemigo]
energy: [Die Energie, la energía]
engine: [Der Motor, el motor]
engineer: [Der Ingenieur, el ingeniero]
english: [Das Englisch, el Inglés]
enthusiasm: [Die Begeisterung, el entusiasmo]
entrance: [Der Eingang, la entrada]
entry: [Der Eintritt, la entrada]
envelope: [Der Umschlag, la envoltura]
environment: [Die Umgebung, el medio ambiente]
equipment: [Die Ausrüstung, el equipo]
error: [Der Fehler, el error]
escape: [Die Flucht, el escape]
estate: [Das Anwesen, la finca]
evening: [Der Abend, la noche]
event: [Das Ereignis, el evento]
evidence: [Der Beweis, la evidencia]
example: [Das Beispiel, el ejemplo]
exchange: [Der Austausch, el intercambio]
excitement: [Die Aufregung, la emoción]
excuse: [Die Entschuldigung, la excusa]
executive: [Die Exekutive, el ejecutivo]
exercise: [Die Übung, el ejercicio]
existence: [Die Existenz, la existencia]
expense: [Der Aufwand, el gasto]
experience: [Das Erlebnis, la experiencia]
expert: [Der Experte, el experto]
explanation: [Die Erklärung, la explicación]
explosion: [Die Explosion, la explosión]
expression: [Der Ausdruck, la expresión]
eye: [Das Auge, el ojo]
fabric: [Das Gewebe, la tela]
face: [Das Gesicht, la cara]
facility: [Die Einrichtung, la instalación]
fact: [Die Tatsache, el hecho]
factory: [Die Fabrik, la fábrica]
failure: [Das Versagen, el fracaso]
faith: [Der Glaube, la fe]
fall: [Der Herbst, la caída]
family: [Die Familie, la familia]
fan: [Der Fan, el ventilador]
fantasy: [Die Fantasie, la fantasía]
farm: [Der Bauernhof, la granja]
farmer: [Der Bauer, el agricultor]
fashion: [Die Mode, la moda]
fat: [Das Fett, la grasa]
fate: [Das Schicksal, el destino]
father: [Der Vater, el padre]
fault: [Der Fehler, el fallo]
fear: [Die Angst, el miedo]
feature: [Die Eigenschaft, la característica]
feeling: [Das Gefühl, la sensación]
fellow: [Der Kerl, el becario]
female: [Das Weibchen, la hembra]
fence: [Der Zaun, la valla]
fiction: [Die Fiktion, la ficción]
field: [Das Feld, el campo]
fight: [Der Kampf, la lucha]
figure: [Die Figur, la figura]
file: [Die Datei, el archivo]
film: [Der Film, la película]
finger: [Der Finger, el dedo]
fire: [Das Feuer, el fuego]
firm: [Die Firma, la empresa]
fish: [Der Fisch, el pescado]
fishing: [Die Angel, la pesca]
flag: [Die Flagge, la bandera]
flame: [Die Flamme, la llama]
flesh: [Das Fleisch, la carne]
flight: [Der Flug, el vuelo]
floor: [Der Boden, el piso]
flow: [Die Strömung, el flujo]
flower: [Die Blume, la flor]
fluid: [Das Fluid, el fluido]
focus: [Der Fokus, el foco]
folk: [Die Volks, la gente]
food: [Das Essen, la comida]
fool: [Der Dummkopf, el tonto]
foot: [Der Fuß, el pie]
football: [Der Fußball, el fútbol]
force: [Die Kraft, la fuerza]
forest: [Der Wald, el bosque]
form: [Die Form, la forma]
fortune: [Das Glück, la fortuna]
foundation: [Die Grundlage, la fundación]
fragment: [Das Fragment, el fragmento]
frame: [Der Rahmen, la trama]
freedom: [Die Freiheit, la libertad]
french: [Die Franzosen, el francés]
friend: [Der Freund, el amigo]
friendship: [Die Freundschaft, la amistad]
front: [Die Front, el frente]
fruit: [Das Obst, el fruto]
fuel: [Die Kraftstoff, el combustible]
function: [Die Funktion, la función de]
funeral: [Das Begräbnis, el funeral]
furniture: [Die Möbel, los muebles]
future: [Die Zukunft, el futuro]
gallery: [Die Gallerie, la galería]
game: [Das Spiel, el juego]
gang: [Die Gruppe, la pandilla]
gap: [Die Lücke, la brecha]
garage: [Die Garage, el garaje]
garden: [Der Garten, el jardín]
gas: [Das Gas, el gas]
gate: [Die Gate, la puerta]
gaze: [Der Blick, la mirada]
gear: [Das Getriebe, el engranaje]
gene: [Das Gen, el gen]
general: [Die Allgemeine, el general]
generation: [Die Generation, la generación]
gentleman: [Der Gentleman, el caballero]
german: [Der Deutsche, el alemán]
gesture: [Die Geste, el gesto]
ghost: [Das Gespenst, el fantasma]
gift: [Das Geschenk, el regalo]
girl: [Das Mädchen, la chica]
glance: [Der Blick, la mirada]
glass: [Das Glas, el cristal]
glory: [Die Herrlichkeit, la gloria]
goal: [Das Ziel, el objetivo]
god: [Der Gott, el dios]
gold: [Das Gold, el oro]
golf: [Der Golf, el golf]
good: [Das Gute, el bien]
government: [Die Regierung, el gobierno]
governor: [Der Gouverneur, el gobernador]
grade: [Die Klasse, el grado]
grain: [Das Korn, el grano]
grant: [Der Zuschuss, la subvención]
grass: [Das Gras, la hierba]
grave: [Das Grab, la tumba]
green: [Das Grün, el verde]
grip: [Der Griff, la empuñadura]
ground: [Der Boden, el terreno]
group: [Die Gruppe, el grupo]
guard: [Der Wächter, la guardia]
guest: [Der Gast, el invitado]
guide: [Der Führer, la guía]
guilt: [Die Schuld, la culpa]
guitar: [Die Gitarre, la guitarra]
gun: [Die Waffe, la pistola]
guy: [Der Kerl, el chico]
habit: [Die Angewohnheit, el hábito]
hair: [Das Haar, el cabello]
half: [Die Hälfte, la media]
hall: [Die Halle, la sala]
hand: [Die Hand, la mano]
harm: [Der Schaden, el daño]
hat: [Der Hut, el sombrero]
head: [Der Kopf, la cabeza]
health: [Die Gesundheit, la salud]
hearing: [Die Anhörung, la audiencia]
heart: [Das Herz, el corazón]
heat: [Die Hitze, el calor]
heaven: [Der Himmel, el cielo]
heel: [Die Ferse, el talón]
height: [Die Höhe, la altura]
hell: [Die Hölle, el infierno]
help: [Die Hilfe, la ayuda]
hero: [Der Held, el héroe]
hill: [Der Hügel, la colina]
hint: [Der Hinweis, la indirecta]
hip: [Die Hüfte, la cadera]
history: [Die Geschichte, la historia]
hold: [Der Halt, la bodega]
hole: [Das Loch, el agujero]
holiday: [Der Urlaub, las vacaciones]
home: [Das Zuhause, el hogar]
hope: [Die Hoffnung, la esperanza]
horizon: [Der Horizont, el horizonte]
horror: [Der Horror, el horror]
horse: [Das Pferd, el caballo]
hospital: [Das Krankenhaus, el hospital]
host: [Der Gastgeber, el anfitrión]
hotel: [Das Hotel, el hotel]
hour: [Die Stunde, la hora]
house: [Das Haus, la casa]
household: [Der Haushalt, el hogar]
human: [Der Mensch, la humana]
hunting: [Das Jagd, la caza]
husband: [Der Ehemann, el marido]
ice: [Das Eis, el hielo]
idea: [Die Idee, la idea]
identity: [Die Identität, la identidad]
illness: [Die Krankheit, la enfermedad]
image: [Das Bild, la imagen]
imagination: [Die Phantasie, la imaginación]
impact: [Der Aufprall, el impacto]
impression: [Der Eindruck, la impresión de]
incident: [Der Vorfall, el incidente]
individual: [Der Einzelne, el individuo]
industry: [Die Branche, la industria]
infant: [Das Kleinkind, el bebé]
information: [Die Information, la información]
injury: [Die Verletzung, la lesión]
inn: [Das Gasthaus, la posada]
insect: [Das Insekt, el insecto]
inspector: [Der Inspektor, el inspector]
instinct: [Der Instinkt, el instinto]
instruction: [Die Anleitung, la instrucción]
instrument: [Das Instrument, el instrumento]
insurance: [Die Versicherung, el seguro]
intelligence: [Die Intelligenz, la inteligencia]
intention: [Die Absicht, la intención]
interest: [Die Interesse, el interés]
interior: [Der Innenraum, el interior]
interview: [Das Interview, la entrevista]
investigation: [Die Ermittlung, la investigación]
invitation: [Die Einladung, la invitación]
iron: [Das Bügeleisen, el hierro]
island: [Die Insel, la isla]
issue: [Das Thema, la cuestión]
item: [Der Gegenstand, el elemento]
jacket: [Die Jacke, la chaqueta]
jet: [Der Strahl, el chorro]
job: [Der Beruf, el trabajo]
joke: [Der Witz, la broma]
journal: [Das Tagebuch, la revista]
journey: [Die Reise, el viaje]
joy: [Der Spaß, la alegría]
judge: [Der Richter, el juez]
judgment: [Das Urteil, la sentencia]
juice: [Der Saft, el jugo]
jury: [Die Jury, el jurado]
justice: [Die Justiz, la justicia]
key: [Der Schlüssel, la tecla]
kid: [Das Kind, el niño]
killer: [Der Mörder, el asesino]
kind: [Die Art, el tipo]
king: [Der König, el rey]
kingdom: [Das Königreich, el reino]
kiss: [Der Kuss, el beso]
kit: [Das Kit, el kit]
kitchen: [Die Küche, la cocina]
knee: [Das Knie, la rodilla]
knife: [Das Messer, el cuchillo]
knowledge: [Das Wissen, el conocimiento]
lad: [Der Knabe, el muchacho]
lady: [Die Dame, la dama]
lake: [Der See, el lago]
lamp: [Die Lampe, la lámpara]
land: [Das Land, la tierra]
landing: [Die Landung, el aterrizaje]
landscape: [Die Landschaft, el paisaje]
lane: [Die Fahrspur, el carril]
language: [Die Sprache, el idioma]
laugh: [Das Lachen, la risa]
law: [Das Gesetz, la ley]
lawyer: [Der Anwalt, el abogado]
layer: [Die Schicht, la capa de]
lead: [Die Führung, el plomo]
leader: [Der Führer, el líder]
leaf: [Das Blatt, la hoja]
league: [Die Liga, la liga]
leather: [Das Leder, el cuero]
leave: [Der Urlaub, la licencia]
lecture: [Der Vortrag, la conferencia]
leg: [Das Bein, la pierna]
length: [Die Länge, la longitud]
lesson: [Der Unterricht, la lección]
letter: [Der Brief, la letra]
level: [Das Level, el nivel]
liberty: [Die Freiheit, la libertad]
library: [Die Bibliothek, la biblioteca]
lie: [Die Lüge, la mentira]
life: [Das Leben, la vida]
lifetime: [Die Lebensdauer, el tiempo de vida]
lift: [Der Lift, el ascensor]
light: [Das Licht, la luz]
limit: [Das Limit, el límite]
line: [Die Linie, la línea]
link: [Der Link, el enlace]
lion: [Der Löwe, el león]
lip: [Die Lippe, el labio]
list: [Die Liste, la lista]
literature: [Die Literatur, la literatura]
living: [Die Lebenden, los vivos]
load: [Die Ladung, la carga]
location: [Der Ort, la ubicación]
lock: [Das Schloss, la cerradura]
look: [Das Aussehen, la mirada]
lord: [Der Herr, el señor]
loss: [Der Verlust, la pérdida]
lot: [Das Ganze, el lote]
love: [Die Liebe, el amor]
lover: [Der Liebhaber, el amante]
luck: [Das Glück, la suerte]
lunch: [Das Mittagessen, el almuerzo]
lung: [Die Lunge, el pulmón]
machine: [Die Maschine, la máquina]
magazine: [Das Magazin, la revista]
mail: [Die Post, el correo]
male: [Der Mann, el macho]
man: [Der Mann, el hombre]
manager: [Der Geschäftsführer, el gestor]
manner: [Die Methode, la formaSS]
map: [Die Karte, el mapa]
mark: [Die Note, la marca]
market: [Der Markt, el mercado]
marriage: [Die Ehe, el matrimonio]
mass: [Die Masse, la masa]
master: [Der Meister, el maestro]
match: [Das Match, el partido]
mate: [Der Steuermann, el mate]
material: [Das Material, el material]
matter: [Der Grund, la materia]
mayor: [Der Bürgermeister, el alcalde]
meal: [Die Mahlzeit, la comida]
meaning: [Die Bedeutung, el significado]
measure: [Das Maß, la medida]
meat: [Das Fleisch, la carne]
medicine: [Die Medizin, el medicamento]
meeting: [Das Treffen, la reunión]
member: [Das Mitglied, el miembro]
memory: [Das Gedächtnis, la memoria]
menu: [Das Menü, el menú]
merchant: [Der Händler, el comerciante]
mess: [Die Unordnung, el lío]
message: [Die Nachricht, el mensaje]
metal: [Das Metall, el metal]
method: [Die Methode, el método]
middle: [Die Mitte, el centro]
midnight: [Die Mitternachts, la medianoche]
milk: [Die Milch, la leche]
mill: [Die Mühle, el molino]
mind: [Der Geist, la mente]
mine: [Die Mine, la mina]
minister: [Der Minister, el ministro]
minute: [Die Minute, el minuto]
mirror: [Der Spiegel, el espejo]
miss: [Der Fehl, la señorita]
missile: [Die Rakete, el misil]
mission: [Die Mission, la misión]
mistake: [Der Fehler, el error]
model: [Das Model, el modelo]
moment: [Der Moment, el momento]
money: [Das Geld, el dinero]
month: [Der Monat, el mes]
mood: [Die Stimmung, el estado de ánimo]
moon: [Der Mond, la luna]
morning: [Der Morgen, la mañana]
mother: [Die Mutter, la madre]
motion: [Die Bewegung, el movimiento]
motor: [Der Motor, el motor]
mountain: [Der Berg, la montaña]
mouse: [Die Maus, el ratón]
mouth: [Der Mund, la boca]
move: [Die Bewegung, el movimiento]
movement: [Die Bewegung, el movimiento]
movie: [Der Film, la película]
mud: [Der Schlamm, el barro]
murder: [Der Mord, el asesinato]
muscle: [Der Muskel, el músculo]
museum: [Das Museum, el museo]
music: [Die Musik, la música]
musician: [Der Musiker, el músico]
mystery: [Das Mysterium, el misterio]
nail: [Der Nagel, la uña]
name: [Der Name, el nombre]
nation: [Die Nation, la nación]
nature: [Die Natur, la naturaleza]
navy: [Die Marine, la marina]
neck: [Der Hals, el cuello]
need: [Das Bedürfnis, la necesidad]
needle: [Die Nadel, la aguja]
nerve: [Der Nerv, el nervio]
nest: [Das Nest, el nido]
net: [Das Internet, la red]
network: [Das Netzwerk, la red]
newspaper: [Die Zeitung, el periódico]
night: [Die Nacht, la noche]
nightmare: [Der Albtraum, la pesadilla]
noise: [Das Geräusch, el ruido]
nose: [Die Nase, la nariz]
note: [Die Notiz, la nota]
notice: [Die Notiz, la notificación]
notion: [Die Vorstellung, la noción]
novel: [Der Roman, la novela]
number: [Die Anzahl, el número]
nurse: [Die Krankenschwester, la enfermera]
oak: [Die Eiche, el roble]
object: [Das Objekt, el objeto]
observation: [Die Beobachtung, la observación]
ocean: [Der Ozean, el océano]
offer: [Das Angebot, la oferta]
office: [Das Büro, la oficina]
officer: [Der Offizier, el oficial]
official: [Das Offizielle, el funcionario]
oil: [Das Öl, el aceite]
opening: [Die Eröffnung, la apertura]
opera: [Die Oper, la ópera]
operation: [Die Operation, la operación]
operator: [Der Betreiber, el operador]
opinion: [Die Meinung, la opinión]
opportunity: [Die Gelegenheit, la oportunidad]
option: [Die Option, la opción]
order: [Die Bestellung, el orden]
organ: [Die Orgel, el órgano]
organization: [Die Organisation, la organización]
oxygen: [Die Sauerstoff, el oxígeno]
pace: [Die Geschwindigkeit, el ritmo]
pack: [Das Rudel, el paquete]
package: [Das Paket, el paquete]
page: [Die Seite, la página]
pain: [Der Schmerz, el dolor]
paint: [Die Farbe, la pintura]
painter: [Der Maler, el pintor]
painting: [Das Gemälde, la pintura]
pair: [Das Paar, el par]
palace: [Der Palast, el palacio]
palm: [Die Palme, la palma]
panel: [Die Platte, el panel]
panic: [Die Panik, el pánico]
paper: [Das Papier, el documento]
parent: [Das Elternteil, el padre]
park: [Der Park, el parque]
part: [Der Teil, la parte]
partner: [Der Partner, el socio]
party: [Die Party, el partido]
pass: [Der Pass, el pase]
passage: [Der Durchgang, el pasaje]
passenger: [Der Passagier, el pasajero]
passion: [Die Leidenschaft, la pasión]
past: [Die Vergangenheit, el pasado]
patch: [Der Patch, el parche]
path: [Der Pfad, el camino]
patient: [Der Patient, el paciente]
pattern: [Das Muster, el patrón]
pause: [Die Pause, la pausa]
pavement: [Der Bürgersteig, el pavimento]
peace: [Der Frieden, la paz]
peak: [Der Spitzer, el pico]
pen: [Der Stift, la pluma]
people: [Das Volk, el pueblo]
performance: [Die Leistung, el desempeño]
period: [Die Periode, el período]
permission: [Die Erlaubnis, el permiso]
person: [Die Person, la persona]
personality: [Die Persönlichkeit, la personalidad]
pet: [Das Haustier, la mascota]
phone: [Das Telefon, el teléfono]
photo: [Das Foto, la foto]
photograph: [Die Fotografie, la fotografía]
phrase: [Der Satz, la frase]
piano: [Das Klavier, el piano]
picture: [Das Bild, la imagen]
piece: [Das Stück, la pieza]
pig: [Das Schwein, el cerdo]
pile: [Der Stapel, la pila]
pilot: [Der Pilot, el piloto]
pipe: [Das Rohr, la tubería]
pit: [Die Grube, el pozo]
pitch: [Die Tonhöhe, el terreno de juego]
pity: [Das Mitleid, la piedad]
place: [Der Ort, el lugar]
plan: [Der Plan, el plan]
plane: [Das Flugzeug, el plano]
planet: [Der Planet, el planeta]
plant: [Die Pflanze, la planta]
plastic: [Der Kunststoff, el plástico]
plate: [Der Teller, la placa]
platform: [Die Platform, la plataforma]
play: [Das Spiel, el juego]
player: [Der Spieler, el jugador]
pleasure: [Die Freude, el placer]
plot: [Die Handlung, la trama]
pocket: [Die Tasche, el bolsillo]
poem: [Das Gedicht, el poema]
poet: [Der Poet, el poeta]
poetry: [Die Poesie, la poesía]
point: [Der Punkt, el punto]
pole: [Der Pol, el polo]
police: [Die Polizei, la policía]
policeman: [Der Polizist, el policía]
policy: [Die Richtlinie, la política]
pond: [Der Teich, el estanque]
pool: [Das Schwimmbecken, la piscina]
pop: [Die Pop, el pop]
population: [Die Bevölkerung, la población]
port: [Der Hafen, el puerto]
portrait: [Das Porträt, el retrato]
position: [Die Position, la posición]
possession: [Der Besitz, la posesión]
possibility: [Die Möglichkeit, la posibilidad]
post: [Die Post, el cargo]
pot: [Der Topf, la olla]
potato: [Die Kartoffel, la papa]
pound: [Das Pfund, la libra]
power: [Die Macht, el poder]
practice: [Die Übung, la práctica]
prayer: [Das Gebet, la oración]
presence: [Das Vorhandensein, la presencia]
present: [Das Geschenk, la presente]
president: [Der Präsident, el presidente]
press: [Die Presse, la prensa]
pressure: [Der Druck, la presión]
price: [Der Preis, el precio]
pride: [Der Stolz, el orgullo]
priest: [Der Priester, el sacerdote]
prince: [Der Prinz, el príncipe]
princess: [Die Prinzessin, la princesa]
principle: [Das Prinzip, el principio]
print: [Die Druck, la impresión]
prison: [Das Gefängnis, la prisión]
prisoner: [Der Gefangene, el prisionero]
prize: [Der Preis, el premio]
problem: [Das Problem, el problema]
procedure: [Das Verfahren, el procedimiento de]
process: [Der Prozess, el proceso de]
product: [Das Produkt, el producto]
production: [Die Produktion, la producción]
professor: [Der Professor, el profesor]
profile: [Das Profil, el perfil]
program: [Das Programm, el programa]
project: [Das Projekt, el proyecto]
promise: [Das Versprechen, la promesa]
proof: [Der Beweis, la prueba]
property: [Die Eigenschaft, la propiedad]
prospect: [Das Prospekt, la perspectiva]
protection: [Der Schutz, la protección]
protest: [Der Protest, la protesta]
public: [Die Öffentlichkeit, el público]
punishment: [Die Strafe, el castigo]
purpose: [Die Absicht, el propósito]
quality: [Die Qualität, la calidad]
quarter: [Das Viertel, el trimestre]
queen: [Die Königin, la reina]
question: [Die Frage, la cuestión]
rabbit: [Der Hase, el conejo]
race: [Das Rennen, la carrera]
radio: [Das Radio, la radio]
rail: [Die Schiene, el riel]
rain: [Der Regen, la lluvia]
range: [Der Bereich, la gama]
rank: [Der Rang, el rango]
rat: [Die Ratte, la rata]
rate: [Die Rate, la tasa]
reaction: [Die Reaktion, la reacción]
reader: [Der Leser, el lector]
reading: [Das Lesen, la lectura]
reality: [Die Realität, la realidad]
reason: [Der Grund, la razón]
receiver: [Der Empfänger, el receptor]
reception: [Die Rezeption, la recepción]
recognition: [Die Erkennung, el reconocimiento]
record: [Der Datensatz, el registro]
reference: [Die Referenz, la referencia]
reflection: [Die Reflexion, el reflejo]
region: [Die Region, la región]
relation: [Die Beziehung, la relación]
relationship: [Das Verhältnis, la relación]
relative: [Die Relative, la relación]
relief: [Das Relief, el alivio]
religion: [Die Religion, la religión]
remark: [Die Bemerkung, la observación]
rent: [Die Miete, el alquiler]
reply: [Die Antwort, la respuesta]
report: [Bericht, el informe]
reporter: [Der Reporter, el reportero]
reputation: [Der Ruf, la reputación]
request: [Die Anforderung, la solicitud]
research: [Die Forschung, La investigación]
resident: [Der Bewohner, el residente]
resource: [Die Ressource, el recurso]
respect: [Der Respekt, el respeto]
response: [Die Antwort, la respuesta]
responsibility: [Die Verantwortung, la responsabilidad]
rest: [Die Rast, el resto]
restaurant: [Das Restaurant, el restaurante]
result: [Das Ergebnis, el resultado]
return: [Die Rückkehr, el regreso]
review: [Die Überprüfung, la revisión]
rhythm: [Der Rhythmus, el ritmo]
ride: [Die Fahrt, el paseo]
right: [Das Recht, el derecho]
ring: [Der Ring, el anillo]
rise: [Der Aufgang, el aumento]
risk: [Das Risiko, el riesgo]
river: [Der Fluss, el río]
road: [Die Straße, la carretera]
rock: [Der Fels, la roca]
rod: [Die Stange, la varilla]
role: [Die Rolle, el papel]
roll: [Die Rolle, el rollo]
roof: [Das Dach, el techo]
room: [Das Zimmer, la habitación]
root: [Der Ursprung, la raíz]
rope: [Das Seil, la cuerda]
rose: [Die Rose, la rosa]
round: [Die Runde, la ronda]
route: [Die Route, la ruta]
routine: [Die Routine, la rutina]
row: [Die Reihe, la fila]
rule: [Die Regel, la regla]
run: [Die Lauf, la carrera]
running: [Das Rennen, el funcionamiento]
safety: [Die Sicherheit, la seguridad]
sake: [Das Wohl, el bien]
salt: [Das Salz, la sal de]
sample: [Das Muster, la muestra]
sand: [Der Sand, la arena]
sandwich: [Das Sandwich, el sándwich]
satellite: [Der Satellit, el satélite]
satisfaction: [Die Zufriedenheit, la satisfacción]
scale: [Die Skala, la escala]
scene: [Die Szene, la escena]
schedule: [Der Stundenplan, el calendario]
school: [Die Schule, la escuela]
science: [Die Wissenschaft, la ciencia]
scientist: [Der Wissenschaftler, el científico]
score: [Die Punktzahl, la puntuación]
screen: [Der Bildschirm, la pantalla]
sea: [Das Meer, el mar]
search: [Die Suche, la búsqueda]
season: [Die Jahreszeit, la temporada]
second: [Der Zweite, la segunda]
secret: [Das Geheimnis, el secreto]
secretary: [Der Sekretär, el secretario]
section: [Die Sektion, la sección]
security: [Die Sicherheit, la seguridad]
seed: [Die Saat, la semilla]
self: [Das Ich, el auto]
sensation: [Die Sensation, la sensación]
sense: [Der Sinn, el sentido]
sentence: [Der Satz, la sentencia]
sequence: [Die Sequenz, la secuencia]
sergeant: [Der Wachtmeister, el sargento]
servant: [Der Diener, el siervo]
service: [Der Service, el servicio]
session: [Die Sitzung, la sesión]
setting: [Die Einstellung, el ajuste]
sex: [Das Geschlecht, el sexo]
shade: [Die Schattierung, la sombra]
shadow: [Der Schatten, la sombra]
shame: [Die Schande, la vergüenza]
shape: [Die Form, la forma]
share: [Das Teilen, la cuota]
sheep: [Das Schaf, las ovejas]
sheet: [Das Blatt, la hoja de]
shelf: [Das Regal, el estante]
shell: [Die Muschel, la concha]
shift: [Die Verschiebung, el cambio]
ship: [Das Schiff, el barco]
shirt: [Das Hemd, la camisa]
shit: [Die Scheiße, la mierda]
shock: [Der Schock, el choque]
shoe: [Der Schuh, el zapato]
shop: [Das Geschäft, la tienda]
shopping: [Das Einkaufen, las compras]
shore: [Die Küste, la orilla]
shot: [Der Schuss, el disparo]
shoulder: [Die Schulter, el hombro]
show: [Die Show, el show]
shower: [Die Dusche, la ducha]
side: [Die Seite, el lado]
sight: [Die Sehenswürdigkeit, la vista]
sign: [Das Schild, el signo]
signal: [Das Signal, la señal]
silence: [Die Stille, el silencio]
silk: [Die Seide, la seda]
silver: [Das Silber, la plata]
sin: [Die Sünde, el pecado]
singer: [Der Sänger, el cantante]
sir: [Die Sir, el señor]
sister: [Die Schwester, la hermana]
site: [Der Standort, el sitio]
situation: [Die Situation, la situación]
size: [Die Größe, el tamaño]
skill: [Das Können, la habilidad]
skin: [Die Haut, la piel]
skirt: [Der Rock, la falda]
sky: [Der Himmel, el cielo]
sleep: [Der Schlaf, el sueño]
slope: [Die Piste, la pendiente]
smell: [Der Geruch, el olor]
smile: [Das Lächeln, la sonrisa]
smoke: [Der Rauch, el humo]
snow: [Der Schnee, la nieve]
society: [Die Gesellschaft, la sociedad]
soil: [Die Erde, el suelo]
soldier: [Der Soldat, el soldado]
solution: [Die Lösung, la solución]
son: [Der Sohn, el hijo]
song: [Das Lied, la canción]
sort: [Die Art, el tipo]
soul: [Die Seele, el alma]
sound: [Der Klang, el sonido]
source: [Die Quelle, la fuente]
south: [Der Süden, el sur]
space: [Der Raum, el espacio]
speaker: [Der Lautsprecher, el altavoz]
speech: [Die Rede, el discurso]
speed: [Die Geschwindigkeit, la velocidad]
spell: [Der Zauber, el hechizo]
spirit: [Der Geist, el espíritu]
sport: [Der Sport, el deporte]
spot: [Der Platz, el punto]
spring: [Der Frühling, la primavera]
squad: [Die Mannschaft, la escuadra]
square: [Das Quadrat, la plaza]
staff: [Das Personal, el personal]
stage: [Die Bühne, la etapa de]
stake: [Der Einsatz, la estaca]
stand: [Der Stand, el soporte]
standard: [Der Standard, la norma]
standing: [Der Ständige, el pie]
star: [Der Stern, la estrella]
start: [Der Anfang, el inicio]
state: [Der Staat, el estado]
statement: [Die Aussage, la declaración]
station: [Der Bahnhof, la estación]
steam: [Der Dampf, el vapor]
steel: [Der Stahl, el acero]
step: [Der Schritt, la etapa de]
stick: [Der Stock, el palo]
stock: [Die Aktie, la acción]
stomach: [Der Bauch, el estómago]
stone: [Der Stein, la piedra]
stop: [Der Halt, la parada]
storage: [Das Speicher, el almacenamiento]
store: [Das Geschäft, la tienda]
storm: [Der Sturm, la tormenta]
story: [Die Geschichte, la historia]
stranger: [Der Fremde, el desconocido]
stream: [Der Strom, la corriente de]
street: [Die Straße, la calle]
strength: [Die Stärke, la fuerza]
string: [Die Schnur, la cadena de]
strip: [Der Streifen, la tira]
stroke: [Der Hub, el trazo]
structure: [Die Struktur, la estructura]
struggle: [Der Kampf, la lucha]
student: [Der Schüler, el estudiante]
studio: [Das Studio, el estudio]
study: [Die Studium, el estudio]
stuff: [Das Zeug, las cosas]
style: [Der Stil, el estilo]
subject: [Das Thema, el sujeto]
success: [Der Erfolg, el éxito]
sugar: [Der Zucker, el azúcar]
suggestion: [Der Vorschlag, la sugerencia]
suicide: [Die Selbstmord, el suicidio]
suit: [Der Anzug, el traje]
summer: [Der Sommer, el verano]
sun: [Die Sonne, el sol]
supply: [Die Versorgung, el suministro]
support: [Die Unterstützung, el apoyo]
surface: [Die Oberfläche, la superficie]
surgery: [Die Operation, la cirugía]
surprise: [Die Überraschung, la sorpresa]
suspicion: [Der Verdacht, la sospecha]
swimming: [Das Schwimmen, la natación]
switch: [Der Schalter, el interruptor]
sword: [Das Schwert, la espada]
symbol: [Das Symbol, el símbolo]
sympathy: [Die Sympathie, la simpatía]
system: [Das System, el sistema de]
table: [Der Tisch, la tabla]
tail: [Der Schweif, la cola]
tale: [Das Märchen, el cuento]
talent: [Das Talent, el talento]
talk: [Das Gespräch, la charla]
tank: [Der Panzer, el tanque]
tape: [Das Band, la cinta]
target: [Das Ziel, el objetivo]
task: [Die Aufgabe, la tarea]
taste: [Der Geschmack, el sabor]
tax: [Die Steuer, el impuesto]
taxi: [Das Taxi, el taxi]
tea: [Der Tee, el té]
teacher: [Der Lehrer, el profesor]
team: [Das Team, el equipo]
tear: [Die Reiß, el desgarro]
technology: [Die Technologie, la tecnología]
teenager: [Der Teenager, el adolescente]
telephone: [Das Telefon, el teléfono]
television: [Das Fernsehen, la televisión]
temperature: [Die Temperatur, la temperatura]
temple: [Der Tempel, el templo]
tension: [Die Spannung, la tensión]
term: [Der Begriff, el término]
territory: [Das Territorium, el territorio]
test: [Der Test, la prueba]
text: [Der Text, el texto]
theory: [Die Theorie, la teoría]
thing: [Das Ding, la cosa]
thinking: [Das Denken, el pensamiento]
thought: [Der Gedanke, el pensamiento]
threat: [Die Bedrohung, la amenaza]
throat: [Der Hals, la garganta]
ticket: [Das Ticket, el billete]
tide: [Die Gezeiten, la marea]
tie: [Das Band, el empate]
time: [Die Zeit, el tiempo]
tin: [Die Dose, el estaño]
tip: [Das Trinkgeld, la punta]
tissue: [Das Gewebe, el tejido]
title: [Den Titel, el título]
toilet: [Die Toilette, el inodoro]
tone: [Der Ton, el tono]
tongue: [Die Zunge, la lengua]
tool: [Das Werkzeug, la herramienta]
tooth: [Der Zahn, el diente]
top: [Die Spitze, la parte superior]
topic: [Das Thema, el tema]
touch: [Die Berührung, el toque]
tour: [Die Reise, la gira]
tourist: [Der Tourist, el turista]
tower: [Der Turm, la torre]
town: [Die Stadt, la ciudad]
toy: [Das Spielzeug, el juguete]
trace: [Die Spur, la traza]
track: [Die Strecke, la pista]
trade: [Der Handel, el comercio]
tradition: [Die Tradition, la tradición]
traffic: [Der Verkehr, el tráfico]
tragedy: [Die Tragödie, la tragedia]
train: [Der Zug, el tren]
training: [Das Training, la formación]
travel: [Die Reise, el recorrido]
tray: [Die Schale, la bandeja]
treatment: [Die Behandlung, el tratamiento]
tree: [Der Baum, el árbol]
trial: [Die Studie, el juicio]
trick: [Der Trick, el truco]
trip: [Die Reise, el viaje]
troop: [Die Truppe, la tropa]
trouble: [Die Schwierigkeiten, el problema]
truck: [Der Lkw, el camión]
trust: [Das Vertrauen, la confianza]
truth: [Die Wahrheit, la verdad]
tube: [Das Rohr, el tubo]
tune: [Die Melodie, la melodía]
tunnel: [Der Tunnel, el túnel]
turn: [Die Wende, la vuelta]
twin: [Der Zwilling, el gemelo]
type: [Der Typ, el tipo de]
uncle: [Der Onkel, el tío]
understanding: [Das Verständnis, la comprensión]
uniform: [Die Uniform, el uniforme]
union: [Die Union, la unión]
unit: [Die Einheit, la unidad]
universe: [Das Universum, el universo]
university: [Die Universität, la universidad]
use: [Die Verwendung, el uso]
valley: [Das Tal, el valle]
value: [Der Wert, el valor]
van: [Der Van, la furgoneta]
variety: [Die Vielfalt, la variedad]
vegetable: [Das Gemüse, el vegetal]
vehicle: [Das Fahrzeug, el vehículo]
version: [Die Version, la versión]
vessel: [Das Schiff, el buque]
victim: [Das Opfer, la víctima]
victory: [Der Sieg, la victoria]
video: [Das Video, el video]
view: [Die Aussicht, la vista]
village: [Das Dorf, el pueblo]
violence: [Die Gewalt, la violencia]
vision: [Die Sicht, la visión]
visit: [Der Besuch, la visita]
visitor: [Der Besucher, el visitante]
voice: [Die Stimme, la voz]
volume: [Das Volumen, el volumen]
walk: [Das Wandern, la caminata]
wall: [Die Mauer, la pared]
war: [Der Krieg, la guerra]
ward: [Das Mündel, la sala]
warmth: [Die Wärme, el calor]
warning: [Die Warnung, la advertencia]
waste: [Der Müll, los residuos]
watch: [Die Uhr, el reloj]
water: [Das Wasser, el agua]
wave: [Die Welle, la ola]
way: [Der Weg, el camino]
weakness: [Die Schwäche, la debilidad]
weapon: [Die Waffe, el arma]
weather: [Das Wetter, el clima]
week: [Die Woche, la semana]
weekend: [Das Wochenende, el fin de semana]
weight: [Das Gewicht, el peso]
wheel: [Das Rad, la rueda]
white: [Das Weiß, el blanco]
whole: [Das Ganze, el conjunto]
widow: [Die Witwe, la viuda]
wife: [Die Ehefrau, la esposa]
will: [Der Wille, la voluntad]
wind: [Der Wind, el viento]
window: [Das Fenster, la ventana]
wine: [Der Wein, el vino]
wing: [Der Flügel, el ala]
winter: [Der Winter, el invierno]
wire: [Das Kabel, el alambre]
wish: [Der Wunsch, el deseo]
witness: [Der Zeuge, el testigo]
woman: [Die Frau, la mujer]
wonder: [Das Wunder, la maravilla]
wood: [Das Holz, la madera]
wool: [Die Wolle, la lana]
word: [Das Wort, la palabra]
work: [Die Arbeit, la obra]
worker: [Der Arbeiter, el trabajador]
world: [Die Welt, el mundo]
worry: [Die Sorge, la preocupación]
worth: [Der Wert, la pena]
wound: [Die Wunde, la herida]
writer: [Der Verfasser, el escritor]
writing: [Das Schreiben, la escritura]
yard: [Der Hof, el patio]
year: [Das Jahr, el año]
youth: [Die Jugend, la juventud]
zone: [Die Zone, la zona]
